9startPosition=1=0
9endPosition=3=0
0 1 0 1 0 0 0 0 0 0
0 1 0 1 1 1 1 0 0 0
0 1 0 0 0 0 1 0 0 0
0 1 0 0 0 1 1 0 0 0
0 1 0 0 0 1 0 0 0 0
0 1 1 0 0 1 1 0 0 0
0 0 1 0 0 0 1 0 0 0
0 0 1 1 1 1 1 0 0 0
0 0 0 0 0 0 0 0 0 0
0 0 0 0 0 0 0 0 0 0