#startPosition=0=0
#endPosition=9=9
1 1 1 1 0 0 0 0 0 0
0 0 0 1 0 0 0 0 0 0
0 0 0 1 1 1 1 1 1 0
0 0 0 0 0 0 0 0 1 0
1 1 1 1 1 1 1 1 1 0
1 0 0 0 0 0 0 0 0 0
1 0 0 0 0 0 1 1 1 0
1 1 1 1 1 0 1 0 1 0
0 0 0 0 1 1 1 0 1 0
0 0 0 0 0 0 0 0 1 1